afar : "conjClass, pdgmSubType, pdgmType, polarity, tam, tokenType"

akkadian-OB : "ablautClass, dervStem, rootClass, tam, verbMorphClass"

alaaba : "polarity, tam, tensefutProx, verbMorphClass"

arabic : "aspect, dervStem, mood, tense, voice"

arbore : "clauseType, conjClass, dervStem, patternClass, pdgmType, polarity, prefixGroup, selectorGroup, stemClass, subconjClass, tam, tokenType"

awngi : "clauseType, defClass, polarity, tam, varB, varClass, verbMorphClass"

bayso : "conjClass, polarity, tam, verbMorphClass"

beja-arteiga : "bar, conjClass, tam, polarity, rootClass"

beja-atmaan : "conjClass, conjSubType, dervStem, dervStemAug, genderObj, morphClass, nonFiniteForm, numObj, pdgmType, persObj, polarity, proClass, rootClass, stemClass, stemPattern, strength, tam, verbMorphClass"

beja-beniamer : "conjClass, conjSubType, langComp, morphClass, pdgmSubType, pdgmType, polarity, rootClass, stemClass, tam, type"

beja-bishari : "conjClass, dervStem, nonFiniteForm, polarity, proClass, rootClass, tam, verbMorphClass"

beja-hadendowa : "clause, clauseType, conjClass, dervStem, lexlabel, nonFiniteForm, polarity, rootClass, tam, verbMorphClass"

bilin : "aspect, clauseType, conjClass, finiteForm, numberGenderHead, pdgmType, pngSet, polarity, tam, verbMorphClass"

boni : "conjClass, polarity, tam"

boni-jara : "aspect, conjClass, mood, polarity, tam, tokenType, verbMorphClass"

boni-kilii : "aspect, cliticClass, cliticType, conjClass, deAdjClass, mood, polarity, tam, tokenType, type, verbMorphClass"

burji : "clauseMarker, conjClass, dervStem, focus, pdgmType, polarity, proType, tam, verbClass, verbMorphClass"

coptic-sahidic : ", clauseConjugation, clauseType, formClass, polarity, stemClass, tam"

dahalo : "aspect, polarity, tam"

dhaasanac : "pdgmType, pngShapeClass, tam"

dhaasanac-standard : "pdgmType, pngShapeClass, tam"

elmolo : "conjClass, dervCat, patternClass, pdgmSubType, polarity, position, tam, verbMorphClass"

gawwada : "inflClass, pdgmType, polarity, proClasspolarity, tense1, tense2, verbMorphClass"

gedeo : "polarity, tam"

geez : "conjClass, dervStem, rootClass, stemClass, tam, verbMorphClass"

hadiyya : "polarity, tam, verbMorphClass"

hebrew : "ablautClass, dervStem, rootClass, tam, verbMorphClass"

iraqw : "conjClass, mood, polarity, selBE, tam, verbMorphClass"

kambaata : "polarity, tam, verbMorphClass"

kemant : "aspect, genderHeadRel, numHeadRel, pdgmSubType, pdgmType, polarity, tam, tokenType, vSubjSet"

khamtanga : "clauseType, conjClass, genderHead, genderPoss, numHead, polarity, tam, verbMorphClass"

koorete : "conjClass, focus, pdgmClass, polarity, tam"

maale : "aspect, clauseType, modal, polarity, verbMorphClass"

oromo : "orm, dervStem, tam, polarity,  clauseType"

rendille : "clauseType, conjClaspdgmLexs, conjClass, conjSubType, dervStem, polarity, tam"

saho : "conjClass, dervStem, nonFiniteForm, polarity, tam"

shinassha : "complement, conjClass, mood, polarity, tam, verbMorphClass"

sidaama : "aspect, clauseType, configuration, pdgmType, polarity, tam, verbMorphClass"

somali-standard : "clauseCase, clauseType, conjClass, conjSubClass, pdgmType, pngShapeClass, polarity, tam"

tsamakko : "conjClass, polarity, stemShape, suffSet, tam, verbMorphClass"

wolaytta : "complement, mood, polarity, tam, verbMorphClass"

yaaku : "aspect, case, conjClass, copForm, polarity, tam, verbMorphClass"

yemsa : "conjClass, polarity, tam, verbMorphClass"

