# 06/03/13: property-list conflated with lang abbrev. list.
# In the following, each language name is followed by " :  " and then a quoted list 
# consisting of the aama langName abbreviation, followed by the obligatory properties 
# for a finite verb in that language.
# Format: language : "lang-abbrev, prop, prop, prop, . . ."

afar : "afr, conjClass, pdgmSubType, pdgmType, polarity, tam, tokenType"

akkadian-OB : "aob, ablautClass, derivedStem, rootClass, tam, verbMorphClass"

alaaba : "alb, polarity, tam, tensefutProx, verbMorphClass"

arabic : "arb, aspect, derivedStem, mood, tense, voice"

arbore : "abr, clauseType, conjClass, derivedStem, patternClass, pdgmType, polarity, prefixGroup, selectorGroup, stemClass, subconjClass, tam, tokenType"

awngi : "awn, clauseType, defClass, polarity, tam, varB, varClass, verbMorphClass"

bayso : "bay, conjClass, polarity, tam, verbMorphClass"

beja-arteiga : "bar, conjClass, tam, polarity, rootClass"

beja-atmaan : "bat, conjClass, conjSubType, derivedStem, derivedStemAug, genderObj, morphClass, nonFiniteForm, numObj, pdgmType, persObj, polarity, proClass, rootClass, stemClass, stemPattern, strength, tam, verbMorphClass"

beja-beniamer : "bbe, conjClass, conjSubType, langComp, morphClass, pdgmSubType, pdgmType, polarity, rootClass, stemClass, tam, type"

beja-bishari : "bbi, conjClass, derivedStem, nonFiniteForm, polarity, proClass, rootClass, tam, verbMorphClass"

beja-hadendowa : "bha, clause, clauseType, conjClass, derivedStem, lexlabel, nonFiniteForm, polarity, rootClass, tam, verbMorphClass"

bilin : "bil, aspect, clauseType, conjClass, finiteForm, numberGenderHead, pdgmType, pngSet, polarity, tam, verbMorphClass"

boni : "bon, conjClass, polarity, tam"

boni-jara : "boj, aspect, conjClass, mood, polarity, tam, tokenType, verbMorphClass"

boni-kilii : "bok, aspect, cliticClass, cliticType, conjClass, deAdjClass, mood, polarity, tam, tokenType, type, verbMorphClass"

burji : "bur, clauseMarker, conjClass, derivedStem, focus, pdgmType, polarity, proType, tam, verbClass, verbMorphClass"

coptic-sahidic : "csa, clauseConjugation, clauseType, formClass, polarity, stemClass, tam"

dahalo : "dah, aspect, polarity, tam"

dhaasanac : "dha, pdgmType, pngShapeClass, tam"

dhaasanac-standard : "dhast, pdgmType, pngShapeClass, tam"

elmolo : "elm, conjClass, dervCat, patternClass, pdgmSubType, polarity, position, tam, verbMorphClass"

gawwada : "gaw, inflClass, pdgmType, polarity, proClasspolarity, tense1, tense2, verbMorphClass"

gedeo : "ged, polarity, tam"

geez : "gez, conjClass, derivedStem, rootClass, stemClass, tam, verbMorphClass"

hadiyya : "had, polarity, tam, verbMorphClass"

hebrew : "heb, ablautClass, derivedStem, rootClass, tam, verbMorphClass"

iraqw : "irq, conjClass, mood, polarity, selBE, tam, verbMorphClass"

kambaata : "kam, polarity, tam, verbMorphClass"

kemant : "kem, aspect, genderHeadRel, numHeadRel, pdgmSubType, pdgmType, polarity, tam, tokenType, vSubjSet"

khamtanga : "khm, clauseType, conjClass, genderHead, genderPoss, numHead, polarity, tam, verbMorphClass"

koorete : "kor, conjClass, focus, pdgmClass, polarity, tam"

maale : "mal, aspect, clauseType, modal, polarity, verbMorphClass"

oromo : "orm, derivedStem, tam, polarity,  clauseType"

rendille : "ren, clauseType, conjClaspdgmLexs, conjClass, conjSubType, derivedStem, polarity, tam"

saho : "sah, conjClass, derivedStem, nonFiniteForm, polarity, tam"

shinassha : "shn, complement, conjClass, mood, polarity, tam, verbMorphClass"

sidaama : "sid, aspect, clauseType, configuration, pdgmType, polarity, tam, verbMorphClass"

somali-standard : "sst, clauseCase, clauseType, conjClass, conjSubClass, pdgmType, pngShapeClass, polarity, tam"

tsamakko : "tsm, conjClass, polarity, stemShape,  tam, verbMorphClass"

wolaytta : "wol, complement, mood, polarity, tam, verbMorphClass"

yaaku : "yak, aspect, case, conjClass, copForm, polarity, tam, verbMorphClass"

yemsa : "yem, conjClass, polarity, tam, verbMorphClass"

