

afar : "afr, conjClass, mainStem, nonFiniteForm, pdgmType, polarity, tam"

akkadian-ob : "aob" no non-finite pdgm

alaaba : "alb, causativeAllomorph, derivedStem, multiLex, pdgmType, stemFinalC, verbMorphClass"

arabic : "arb, derivedStem, infinitive, infinitiveVar, state, stem, verbMorphClass, voice"

arbore : "abr, conjClass, derivedStem, infinitiveClass, morphoSynEnv, multiLex, nonFiniteForm, patternClass, pdgmType, stemAltClass"

awngi : "awn" no non-finite pdgm

bayso : "bay, formType, tam, tamStemForm, verbMorphClass"

beja-arteiga : "bar, conjClass, derivedStem, derivedStemAug, formType, multiLex, nonFiniteForm, participle, pdgmType, polarity, rootClass, tam, tamStemClass"

beja-atmaan : "bat, conjClass, conjSubType, multiLex, nonFiniteForm, pdgmType, polarity, rootClass"

beja-beniamer : "bbe, conjClass, derivedStem, derivedStemAug, multiLex, pdgmType, polarity, stemType, tam"

beja-bishari : "bbi, conjClass, multiLex, rootClass"

beja-hadendowa : "bha, conjClass, derivedStem, multiLex, nomForm, nonFiniteForm, polarity, rootClass, tam, verbMorphClass"

bilin : "bil" no non-finite pdgm

boni-jara : "boj" no non-finite pdgm

boni-kijee-bala : "bob" no non-finite pdgm

boni-kilii : "bok" no non-finite pdgm

burji : "bur, formType, polarity, present, proType, suppletion, tam, verbClass"

burunge : "brn" no non-finite pdgm

coptic-sahidic : "csa, clauseConjugation, imperativeForm, infinitiveForm, morphClass, objectGender, objectNumber, objectPerson, objectType, polarity, stemClass, tam"

dahalo : "dah" no non-finite pdgm

dhaasanac : "dha,Error 503: The query timed out (restricted to null ms)Fuseki - version 1.0.1 (Build date: 2014-01-18T19:01:20+0000)

dizi : "diz" no non-finite pdgm

egyptian-middle : "egm" no non-finite pdgm

elmolo : "elm" no non-finite pdgm

gawwada : "gaw" no non-finite pdgm

gedeo : "ged" no non-finite pdgm

geez : "gez" no non-finite pdgm

hadiyya : "had" no non-finite pdgm

hebrew : "heb" no non-finite pdgm

iraqw : "irq, genderHead, imprtvClass, numHead, polarity, posHead, tam, verbMorphClass"

kambaata : "kam" no non-finite pdgm

kemant : "kem, derivedStem, finiteForm, multiLex, pdgmSubType, pdgmType, polarity"

khamtanga : "khm" no non-finite pdgm

koorete : "kor, derivedStem, multilex, verbMorphClass"

maale : "mal" no non-finite pdgm

oromo : "orm, copType, derivedStem, nonFiniteForm, pdgmSubType, polarity, tam"

rendille : "ren" no non-finite pdgm

saho : "sah" no non-finite pdgm

shinassha : "shn" no non-finite pdgm

sidaama : "sid" no non-finite pdgm

somali-standard : "sst, clauseType, conjClass, conjSubClass, multiLex, nonFiniteForm, numPersGender, pdgmSubType, pdgmType, polarity, tam"

syriac : "syr" no non-finite pdgm

tsamakko : "tsm" no non-finite pdgm

wolaytta : "wol" no non-finite pdgm

yaaku : "yak" no non-finite pdgm

yemsa : "yem,