

afar : "afr, case, gender, number, person, proClass"

akkadian-ob : "aob, case, deixis, gender, genderHead, numHead, number, person, proClass"

alaaba : "alb" no pro pdgm

arabic : "arb" no pro pdgm

arbore : "abr, case, defClass, deixis, gender, genderPoss, mood, numPoss, number, person, polarity, proClass, selectorProClass, suffixType, tam"

awngi : "awn" no pro pdgm

bayso : "bay, case, gender, genderObj, numObj, number, person, proClass"

beja-arteiga : "bar, case, defClass, deixis, gender, langVar, number, pdgmType, person, proClass"

beja-atmaan : "bat, case, gender, genderHead, genderObj, genderPoss, multiLex, numHead, numObj, number, pdgmType, persObj, person, polarity, proClass"

beja-beniamer : "bbe, case, gender, genderHead, genderPoss, numHead, number, pdgmSubType, person, proClass, stemFinal"

beja-bishari : "bbi, case, caseHead, gender, genderCop, genderHead, genderP1, genderPoss, numCop, numHead, numP1, numP2, numPoss, number, pdgmType, persCop, persP1, persP2, person, proClass, tam"

beja-hadendowa : "bha, case, gender, genderHead, genderPoss, numHead, numPoss, number, pdgmType, person, proClass"

bilin : "bil, case, gender, number, person, proClass"

boni-jara : "boj, formType, gender, number, person, proClass"

boni-kijee-bala : "bob" no pro pdgm

boni-kilii : "bok, formType, gender, number, person, proClass"

burji : "bur" no pro pdgm

burunge : "brn" no pro pdgm

coptic-sahidic : "csa, gender, genderHead, morphClass, number, numberHead, person, proClass"

dahalo : "dah" no pro pdgm

dhaasanac : "dha, case, cohesion, emphatic, number, person, proClass"

dizi : "diz" no pro pdgm

egyptian-middle : "egm, gender, number, person, proClass"

elmolo : "elm, gender, number, person, proClass, synEnv"

gawwada : "gaw" no pro pdgm

gedeo : "ged" no pro pdgm

geez : "gez" no pro pdgm

hadiyya : "had, interrogClass, proClass"

hebrew : "heb" no pro pdgm

iraqw : "irq" no pro pdgm

kambaata : "kam" no pro pdgm

kemant : "kem, gender, number, person, proClass, proSet"

khamtanga : "khm, case, deixis, gender, multiLex, number, pdgmType, person, proClass"

koorete : "kor" no pro pdgm

maale : "mal" no pro pdgm

oromo : "orm, case, gender, number, person, proClass"

rendille : "ren, case, cliticType, cohesion, deixis, focus, gender, number, person, proClass"

saho : "sah, case, gender, number, person, proClass"

shinassha : "shn" no pro pdgm

sidaama : "sid" no pro pdgm

somali-standard : "sst, case, conjSubType, gender, genderPoss, number, person, proClass"

syriac : "syr" no pro pdgm

tsamakko : "tsm" no pro pdgm

wolaytta : "wol" no pro pdgm

yaaku : "yak" no pro pdgm

yemsa : "yem,