afar : "afr, conjClass, gloss, mainStem, nonFiniteForm, pdgmType, polarity, tam"

akkadian-ob : "aob, ablautClass, derivedStem, rootClass, tam, verbMorphClass"

alaaba : "alb, causativeAllomorph, derivedStem, pdgmType, pid, stemFinalC, verbMorphClass"

arabic : "arb, derivedStem, infinitive, infinitiveVar, rootClass, state, stem, verbMorphClass, voice"

arbore : "abr, classification, classlabel, conjClass, derivedStem, focus, gloss, infinitiveClass, morphoSynEnv, nonFiniteForm, note, patternClass, pdgmType, stemAltClass, subconjClass, subjectIdent, subjectVerbAgreement"

awngi : "awn,

bayso : "bay, conjClass, derivedStemAug, formType, polarity, tam, tamStemForm, verbMorphClass"

beja-arteiga : "bar, conjClass, conjType, derivedStem, derivedStemAug, formType, lexnote, nonFiniteForm, participle, pdgmType, polarity, rootClass, tam, tamStemClass"

beja-atmaan : "bat, caseHead, clauseType, conjClass, conjSubType, formFrequency, genderHead, headPosition, nonFiniteForm, pdgmType, polarity, rootClass"

beja-beniamer : "bbe, conjClass, derivedStem, derivedStemAug, gloss, note, pdgmType, polarity, stemType, tam"

beja-bishari : "bbi, conjClass, rootClass"

beja-hadendowa : "bha, aspect, conjClass, derivedStem, mood, nomForm, nonFiniteForm, polarity, rootClass, tam, verbMorphClass"

bilin : "bil, aspect, conjClass, copType, derivedStem, polarity, tam, verbMorphClass"

boni-jara : "boj, cliticClass, cliticType, conjClass, formType, polarity, tam, verbMorphClass"

boni-kijee-bala : "bob,

boni-kilii : "bok, conjClass, formType, polarity, tam, verbMorphClass"

burji : "bur, conjClass, derivedStem, formType, polarity, present, proType, suppletion, tam, verbClass, verbMorphClass"

burunge : "brn, affirmationType, clauseTypeSel, derivedStem, genderHead, gramFunction, imprtvComponent, orientationSel, polarity, predType, stemClass, subjectTypeSelector, tam, tenseSel, type, verbMorphClass"

coptic-sahidic : "csa, clauseConjugation, imperativeForm, infinitiveForm, morphClass, objectGender, objectNumber, objectPerson, objectType, polarity, stemClass, tam, transitivity"

dahalo : "dah, selector, selectorPosition, verbMorphClass"

dhaasanac : "dha, conjClass, derivedStem, derivedStemAug, extended, formType, nonFiniteForm, pdgmSubType, pdgmType, pngShapeClass, polarity, tam, verbMorphClass, verbType"

dizi : "diz, derivedStem, nonMainForm, tam, verbMorphClass"

egyptian-middle : "egm,

elmolo : "elm, conjClass, final, statusClass"

gawwada : "gaw, classification, derivedStem, focusType, inflClass, pdgmType, verbMorphClass"

gedeo : "ged,

geez : "gez, derivedClass, derivedStem, rootClass, stemClass, tam, verbMorphClass"

hadiyya : "had, derivedStem, verbMorphClass"

hebrew : "heb, ablautClass, derivedStem, rootClass, tam, verbMorphClass"

iraqw : "irq, category, conjClass, derivedStem, genderHead, genderObj, imprtvClass, numHead, numObj, numSubj, persObj, persSubj, polarity, posHead, selectorBE, selectorCategory, selectorClass, selectorMood, selectorTense, tam, verbMorphClass"

kambaata : "kam, class, gloss, verbMorphClass"

kemant : "kem, derivedStem, finiteForm, gloss, pdgmSubType, pdgmType, polarity"

khamtanga : "khm, conjClass, nonFiniteForm, verbMorphClass"

koorete : "kor, conjClass, derivedStem, verbMorphClass"

maale : "mal, derivedStem, polarity, rootStructure, temporal, verbMorphClass"

oromo : "orm, copType, derivedStem, nonFiniteForm, pdgmSubType, polarity, tam"

rendille : "ren, conjClass, conjSubType, derivedStem"

saho : "sah, conjClass, tam, tenseName, verbMorphClass"

shinassha : "shn, conjClass, derivedStem, vClass, verbMorphClass"

sidaama : "sid, causative1Causative2, classification, derivedStem, middleClass, passiveReciprocalClass, pdgmType, verbMorphClass"

somali-standard : "sst, clauseCase, clauseType, conjClass, conjSubClass, nonFiniteForm, numPersGender, numberPersonGender, pdgmSubType, pdgmType, polarity, prefix, subConj, tam"

syriac : "syr,

tsamakko : "tsm, conj, conjClass, derivedClass, derivedStem, polarity, suffixSet, tam, verbMorphClass"

wolaytta : "wol, derived, vClass, verbMorphClass"

yaaku : "yak, aspect, conjClass, derivedStem, polarity, tam, verbMorphClass"

yemsa : "yem, conj2, conj3, conjClass, derived, form, gloss, mood, polarity, tam, templ, verbMorphClass"

beja-arteiga : "bar,?multiLexLabel	"DERVSTEMFORM"	"conjClass, DERVSTEMFORM"	"derivedStem, DERVSTEMFORM"	"derivedStemAug, DERVSTEMFORM"	"pdgmType, DERVSTEMFORM"	"rootClass, DERVSTEMFORM"	"DERVSTEMFORM"	"TENSESTEM"	"conjClass, TENSESTEM"	"derivedStem, TENSESTEM"	"derivedStemAug, TENSESTEM"	"formType, TENSESTEM"	"rootClass, TENSESTEM"	"tamStemClass, TENSESTEM"	"VERBALPARTICIPLES"	"conjClass, VERBALPARTICIPLES"	"derivedStem, VERBALPARTICIPLES"	"nonFiniteForm, VERBALPARTICIPLES"	"participle, VERBALPARTICIPLES"	"VERBALPARTICIPLES"	"VERBALPARTICIPLES"	