
afar : "afr, conjClass, formType, pdgmSubType, pdgmType, polarity, tam"

akkadian-ob : "aob, ablautClass, derivedStem, rootClass, tam, verbMorphClass"

alaaba : "alb, clauseType, polarity, tam, verbMorphClass"

arabic : "arb, aspect, derivedStem, mood, tam, voice"

arbore : "abr, clauseType, conjClass, derivedStem, formType, note, patternClass, pdgmType, polarity, stemClass, subconjClass, tam"

awngi : "awn, clauseType, defClass, polarity, tam, varB, varClass, verbMorphClass"

bayso : "bay, conjClass, polarity, tam, verbMorphClass"

beja-arteiga : "bar, conjClass, derivedStem, derivedStemAug, formType, pdgmType, polarity, rootClass, tam"

beja-atmaan : "bat, conjClass, conjSubType, derivedStemAug, genderObj, nonFiniteForm, numObj, pdgmType, persObj, polarity, proClass, rootClass, stemClass, stemPattern, strength, tam"

beja-beniamer : "bbe, conjClass, conjSubType, morphClass, pdgmSubType, pdgmType, polarity, rootClass, stemClass, tam, type"

beja-bishari : "bbi, conjClass, derivedStem, nonFiniteForm, polarity, proClass, rootClass, tam, verbMorphClass"

beja-hadendowa : "bha, clause, clauseType, conjClass, derivedStem, nonFiniteForm, polarity, rootClass, tam, verbMorphClass"

bilin : "bil, aspect, clauseType, conjClass, finiteForm, numberGenderHead, pdgmType, pngSet, polarity, tam, verbMorphClass"

boni-jara : "boj, aspect, conjClass, formType, mood, polarity, tam, verbMorphClass"

boni-kijee-bala : "bob, conjClass, polarity, tam"

boni-kilii : "bok, aspect, cliticClass, cliticType, conjClass, deAdjClass, formType, mood, polarity, tam, type, verbMorphClass"

burji : "bur, clauseMarker, conjClass, derivedStem, focus, formType, pdgmType, polarity, proType, tam, verbClass, verbMorphClass"

burunge : "brn, affirmationType, clauseTypeSel, derivedStem, genderHead, genderObj, numObj, numSubj, orientationSel, polarity, predType, selectorCategory, selectorFormant, stemClass, stemInflCategory, stemInflMorpheme, subjectTypeSelector, tam, tenseSel, verbMorphClass"

coptic-sahidic : "csa, clauseConjugation, clauseType, formClass, polarity, stemClass, tam"

dahalo : "dah, aspect, polarity, tam"

dhaasanac : "dha, pdgmType, pngShapeClass, tam"

dizi : "diz, gender-negAux, morphClass, polarity, tam, verbMorphClass"

egyptian-middle : "egm" no finite pdgm

elmolo : "elm, conjClass, derivedCategory, patternClass, pdgmSubType, polarity, position, tam, verbMorphClass"

gawwada : "gaw, inflClass, pdgmType, polarity, tense2, verbMorphClass"

gedeo : "ged, polarity, tam"

geez : "gez, conjuctive, derivedStem, rootClass, stemClass, tam, verbMorphClass"

hadiyya : "had, polarity, tam, verbMorphClass"

hebrew : "heb, ablautClass, derivedStem, rootClass, tam, verbMorphClass"

iraqw : "irq, conjClass, mood, polarity, selectorBE, tam, verbMorphClass"

kambaata : "kam, polarity, tam, verbMorphClass"

kemant : "kem, aspect, formType, genderHeadRel, numHeadRel, pdgmSubType, pdgmType, polarity, tam, vSubjectSet"

khamtanga : "khm, clauseType, conjClass, genderHead, genderPoss, numHead, polarity, tam, verbMorphClass"

koorete : "kor, conjClass, focus, pdgmClass, polarity, tam"

maale : "mal, clauseType, modal, polarity, verbMorphClass"

oromo : "orm, clauseType, derivedStem, formType, polarity, tam"

rendille : "ren, clauseType, conjClaspdgmLexs, conjClass, conjSubType, derivedStem, polarity, tam"

saho : "sah, conjClass, derivedStem, nonFiniteForm, polarity, tam"

shinassha : "shn, complement, conjClass, mood, polarity, tam, verbMorphClass"

sidaama : "sid, aspect, clauseType, configuration, pdgmType, polarity, tam, verbMorphClass"

somali-standard : "sst, clauseCase, clauseType, conjClass, conjSubClass, pdgmType, pngShapeClass, polarity, tam"

syriac : "syr" no finite pdgm

tsamakko : "tsm, conjClass, polarity, stemShape, suffixSet, tam, verbMorphClass"

wolaytta : "wol, complement, mood, polarity, tam, verbMorphClass"

yaaku : "yak, aspect, case, conjClass, copForm, polarity, tam, verbMorphClass"

yemsa : "yem, conjClass, polarity, tam, verbMorphClass"