

afar : "afr" no noun pdgm

akkadian-ob : "aob" no noun pdgm

alaaba : "alb" no noun pdgm

arabic : "arb" no noun pdgm

arbore : "abr" no noun pdgm

awngi : "awn" no noun pdgm

bayso : "bay, multiLex, nounMorphClass, numRef, numberGender"

beja-arteiga : "bar, case, pdgmType, pluralClass, postposition, postpositionClass"

beja-atmaan : "bat" no noun pdgm

beja-beniamer : "bbe" no noun pdgm

beja-bishari : "bbi" no noun pdgm

beja-hadendowa : "bha, gender, genderHead, genderN1, genderN2, genderPoss, nounMorphClass, numN1, numPoss"

bilin : "bil" no noun pdgm

boni-jara : "boj" no noun pdgm

boni-kijee-bala : "bob" no noun pdgm

boni-kilii : "bok" no noun pdgm

burji : "bur" no noun pdgm

burunge : "brn, nounClass, predType"

coptic-sahidic : "csa" no noun pdgm

dahalo : "dah" no noun pdgm

dhaasanac : "dha" no noun pdgm

dizi : "diz" no noun pdgm

egyptian-middle : "egm" no noun pdgm

elmolo : "elm" no noun pdgm

gawwada : "gaw" no noun pdgm

gedeo : "ged" no noun pdgm

geez : "gez" no noun pdgm

hadiyya : "had" no noun pdgm

hebrew : "heb" no noun pdgm

iraqw : "irq" no noun pdgm

kambaata : "kam" no noun pdgm

kemant : "kem, nounClass"

khamtanga : "khm, case, defClass, gender, multiLex, nounMorphClass, numClass, number, pdgmType, pluralClass, stemClass"

koorete : "kor" no noun pdgm

maale : "mal" no noun pdgm

oromo : "orm" no noun pdgm

rendille : "ren" no noun pdgm

saho : "sah" no noun pdgm

shinassha : "shn" no noun pdgm

sidaama : "sid" no noun pdgm

somali-standard : "sst" no noun pdgm

syriac : "syr" no noun pdgm

tsamakko : "tsm" no noun pdgm

wolaytta : "wol" no noun pdgm

yaaku : "yak, conjClass, gender, number, proClass"

yemsa : "yem,